1111111111111111111111111111111111111111111111111111
1011000000C0011000000C0011000000C0011000000C00000001
1000011111000000111110000001111100000011111001111001
100110E000010110000010001000100010001000100011111001
10000000000001100000100C001100000100C001100000110011
1011000000C00110000011000001100000100011000001100111
1000011111000000000001100000110000011000001100000111
1000011100000000C00000000111000110000011000001100111
100011101100000000000000000C0011000C0011000C00110111
1P011000000100C0011000C0011000C00110C0010C0011000011
1111111111111111111111111111111111111111111111111111